%%%%%%%%%%%%%%%%%%%%%%%%%%%%%%
%.      % % %P             %.%
%       % % %%%%%% %%%%%%% % %
%       %        %     % %   %
%%%%% %%%%% %%% %% %%%%% % %%%
%   % % % %   %    %     %   %
% %%% % % % %%%%%%%% %%% %%% %
%       %     %%     % % %   %
%%%   %%%%%%% %%%% %%% % % % %
% %           %%     %     % %
% % %%%%% % %%%% % %%% %%% % %
%   %     %      % %   % %%% %
%.    %%%%%      % %%% %    .%
%%%%%%%%%%%%%%%%%%%%%%%%%%%%%%
